##########
# @  $  !#
##########
;
####
#! ##
# $ #
# @ #
#####
;
#####
#   ####
#   $@!#
########
;
########
#   #  #
# @    #
## ###!#
 # $   #
 #   ###
 #####
;
####
#  #
#  #
#  ###
#!$$@#
#  ! #
#   ##
#####
;
 ####
##   #
#    !#
# !   #
###@  #
 # $ #
## $ #
# $ ####
# $!   #
#    ! #
########
;
########
##@   ##
#  $# !#
# # $  #
#  $ # #
#  #!$ #
## !  !#
########
;
 ####  ####
 #  #  #  #
 # $####$ #
 #        #
 # $ #### ##
 ### #  #  #
   # $     #
   ### ## ##
######  # #
#!!  # $#$#
#!!       #
#!!@   ####
########