##########
# @  $  .#
##########
;
####
#. ##
# $ #
# @ #
#####
;
#####
#   ####
#   $@.#
########
;
########
#   #  #
# @    #
## ###.#
 # $   #
 #   ###
 #####
;
####
#  #
#  #
#  ###
#.$$@#
#  . #
#   ##
#####
;
 ####
##   #
#    .#
# .   #
###@  #
 # $ #
## $ #
# $ ####
# $.   #
#    . #
########